1111111111111111111111111111111111111111111111111111111111111111111111111111111111111111111111111111
1000000000000010000000010010011001100001001001000000001100000010001000010111000100001001001100000001
1001001000100000000000000000001001001010000010001100000100001000010000010000000101000000000110000001
11000100C010000001000000101001C000000000011000100000110100000000000010100000111000000000000000100001
1001010000000100010000011001000000000000000000000000000000001000000000000100000010100010000000000101
1010000010000001000000C001000000000111000011000110111C0100000001010000000000111010010000000100001001
1001C0000100110000100011001010000000000000001110100000000000101C100100010011001010100000110010000001
100001000000000000000100000001001C011000000010100010000000001100000110001010010000001000000000011001
1011000000010001100100000000000010000000001000101100000110000010001000010110010000110000000000100111
10100010000000000000000001000010000C0001000000000010000100000000000000000000000000000010000010000101
10000000010010101001000100110C0100000100010000110010100000000000001001110000000110000100100010000001
1000001000101010010000001000100C0001000C000000000000100000000000100100100100000001001100100010000001
1000010001000100100000000100000000010100110001000000101000000000100110000000001101001000000001001001
1000010000011001010100000100100000010010101000001000000C0000010000000001100100C010100100000100000001
1100000000001101010001000000100011010101000100010000100010010000001110101010000000000011110000000011
1000000100001010000010100010000001000100000000000000001000000000101010100001011000000000000010100001
100011001010000000000000100010000000000100011000010000000000101C010001000000000101010000100000100011
1000000100000000100000000000000100000010C01000001001100010010000011011000000C00010101000001001000011
10010100000000000100000000010000000001000100C000000100000C010000000100000000000000000000010101111101
100010100000C000000001100000000000100011001000010000000000001011010000010100000010000100000000001001
1001C00000001C00000100100001000000001000000110101000010000000001000010011000000000100010001000000111
10001000010001101100000110C0010001000000001100001000100011000000000000000001000C01000011000000000001
100100001000000000000000C001000000010010000000000000100010000100000100001001000000000000100010000001
11001001100000100000000000C11011010000000000110C0010010000000100000000000000110000000100001000000001
1000000000000111010101000010100000000010100000010000001000001000011000C01011000000000100100000000001
1001000000100001100010001011000000000000000011010000C001010001000001000100000000000010011000C0100001
1000100000000000100010000010000000110000010101100000010000000000010001000000010000000100100000000001
1000010000000000101C01100001100001010000100001001000000000100100000100000100000100000010010010001001
11001000000000001100010010000000000001110C0000001010110000101000000010111000000000010000000100011001
1101000010000000011010001010000000000000000010000010110010001001010101000101C00001000000000000011001
10000000000000010001110C00010000000000001101110100000000000001000000110100000000111001100C0000000001
1011101000100010000010000000001010000001110001000100000000000000100100001100100000000001000001011011
100011000000000100100C010010000C10000001000101110000000010010000000000001100001100000000001110000001
1000000000000000000100001111100000100001001000000100001000000101010101101000000000000111000010010001
10101011010000010001000000001011000000000000000100001000000000000010001001C00000011000100000000C0101
100001C000100000011101100010000001100010000100010000011000000100000000000000001100000000000000100101
101000100001100000100C00000000010001100C00000000001000000011001000000000100000000C001000000000000001
100000000000101000100101000000000010C000001010101000000000100000000100100000000000010010000000000001
1010010001010000011010001010000000000101C00001000000101001000000000000000000001000000000000000010101
1000100000000000001000000000100100100000000000010010000000000010010001111000001000110011010001010001
1000100001000000000000000000000010000000000000000000100100000010001000000000010000000100000000101001
100000100000011000100000000000000001010000100000C000000000100000010000100000011000100100100000100001
10000000000000100100100000000101000010001C0011001000001100000C10000100101000001001000001000001000001
1000000010000110000010000010010101000000000000100101000100011001010100000100000000100000100000000001
1C0000011101000010000110000001000000000000000000000100010000C010000010100C110000C0C00100101000000001
100000000001001000000001000C000010000010001100000001C11001101100000000001000000000001010100000010001
1000100000000000000000100000001000000101001000000110010001000000010000010001000110000001010001010111
1101000000110100000100000000100010011100100000010000100110000000000000000000001000010000000000000001
10001000000000001C00001000100000010010000000000000000000000011000011000001111000101000000000000CC001
1001100000001000000000010001010000000011000000000101C00001001100010001110000000000000101000001000101
1000000010001100000110001000001010000000000000010000010010101001000000000000101010000111000001001101
1000000010000000110100001001001000110110001100000000001000000C0001100000C001100000010010010000000001
1000100000000100000000000010000000000010000000010001000100000000C00000000001000000010000000000001001
100000010000110000000000000100001100000000010001110001C10001000C000110000010000001010000100100011001
100001100000100100000000010000000000100000100010C010000000000010100000000001100010100000000000010001
1001000000000000010001000000010100100000010001010010000010001001000010000010000000000011011000000101
1000001000000000000010000000100101100010000000000100000010010000000000000000001000111010001001010011
100100000010100001000100C000000100000000111000010C00001000000010110011010000010110010000001100000101
100001010000000000000000100000C0011000000011000011000000010001000000110011000010100C11011100C0000001
1000001000000001000000010100001010000010000000010000010101100000000000001000000110110100000001100011
1011011000010000000000100000010010000000100001000000000010000000010101000101000001000000000000000001
1100000100000000001000000010000001011010000000100000100001010001001010000001000100001000000000100001
1001000001000010010000000000000000010011000000100000100101100100001000100000001010000000001010000001
10000000100000000000000000100C0010100000000100000000011100000100000000001000001000000010000000100001
10011100000000001000010000000001100000000000000000C0000010001000000011011110010000000001001010000001
11000001000101100000000000000000000100011C0C00010000C0C000000000000000000000101101000000001100000001
1000000000100010000011100000001000000110100001100110000000000001001000010100000000100010001010000101
1001000001100000000000000100010010000000000100010000000000000000101000000001000010000C00000010010001
1000000000001000100110000001C001000000000000000000001110000C0110000100010100000001010010000000000001
1000010000000000000001000010110000011100000000000000001100000100100000000000000000000000000000011101
1100000000101001000000100000010000000001000000010000000000000101000001010000100001000000010000000001
1111001100101000C000010010000000000100011001000100101101000100011000000000100010010000000C0000100111
1000100100010100000001000000010000000000000010010111000000000100000000000000000001000010000001000001
1000110100000000010000001000000010110100100010100000000100001000100001000100010100100010000100010001
100010100001000000100000010000000100100100000100000001100000000000000000100000000101000000100000C001
11100000010000001000100000000000000000000010000000010001000100010010000100000011110C1001001111000001
1000001000000000010100010000100000000000100001000000100010000100000100010000000000000001000000000001
1001C0001000000C00010100100001010001000C001000001001000000000010000000000000011010001000010001000001
1101000001010100001000100000101101000000101000000000100001000000C01000000000000011110010001000000001
1000001100000001001001010000010110000000100100000001011000000C01000001000100000000000101000000000001
1100000100000000000100000001000000010101000100010001000010010000000000000000100001100000100C00101001
100001000010100101000000000000000100110C101000010000000000100010000001000000100000110011C00000000111
111000000000001000010010010000000000001C010000000000110000101000001000000000000010000000C00000000001
1001101010000101000011010100001100011000100000001000001000001000010000000010000000001000001000001001
1000000000000100000001100110100100010100000000000001000000000000001010111010001000100000000001000101
11000C0100000101010010000001001110010010000000000000000000000000001001010000000010000000000000010001
10000110000000010C0000001001000001010011000100100000000000000000000000000000010100000000010000000101
1000000010000000000000010000C00000000000000000000100000000001100001001000100010000000000000100000011
1000001001100000000001100000000100000000000000011000011000001011000111000000001111011000010010000101
1001100010011100000001000010011000000000001000010000000001000000000000001010000000000110000000000101
1000000000010000001100000000000001000100000000000001000010000010000000100100110000000001100000000111
1001010001011010100000001000E10001001010000000101000100000000001011000000010000101010000010001000001
11010000000000100001010001010000011000000000000001000000011000000000000010000000000000C0100000000011
1010001100000010000000000001000001010000000000000100101000000101000010000000001000100010010001100011
1000000000000101010000000000000000000000010000100000001001001001100001110000000100000110000001100001
10110010000000000100000001C0000000010010000100000000001100100110100010000000000C000000100C0001000001
1010001010010100000000000100000000101001000100000000100001000000011010100000000010010010000000000001
100P100001000110000000101100010000001000000000001010010000010010000000100100001110010000000100100001
100010000010000001000000110000000000000000000000000C001000011000000101000100000000001000110000000101
1111111111111111111111111111111111111111111111111111111111111111111111111111111111111111111111111111