11111111111111111111
1C000000100000001001
10001001000000C00011
11000C0000C000000001
100C00C00000000C0001
100000C0000100E01011
11000C01C000000100P1
10001100000100101001
100000010C1000110001
1101C010100100000001
1000010000100C000C01
11C1000C000000001001
100C1000C00110100001
10000010010000000001
1000001C100000001001
10000000010001010101
10000010100000011011
110000000000C0000001
10010000000010101001
11111111111111111111