11111111111111111111
10001111000C0100P001
10C01110011000C11011
1CC00000C11000111001
1011101000001011C001
10111C100C0000000111
10C00010011100000111
10010000001110010E01
1000CCC00000C000C001
11111111111111111111