1888A55188888888888A
6XEX0519XXXCXWXXPXX0
6XCX789XX24XXXC24XW0
6CCXXXXXC79XXX2D9XX0
6X234XWXXXXXWX79CXX0
6X789CWXXCXXXXXXX23D
6XCXXXWXXW24XXXXX78A
6XXWXXXXXX79WXXWXXX0
6XXXCCCXXXXXCXXWCXX0
B333333333333333333D