11111111111111111111
10000010000C0100P001
10C01010001000C10011
1CC000000C1000000001
1011001000001001C001
10000C000C0000000101
10C00010010100000101
10010000000010010E01
1000CCC00000C000C001
11111111111111111111