11111111111111111111
11C10100000100000011
101000010CCC10C00001
110C01C0000000CC0011
1C100C00010000001001
1000010E100001010001
10000000000011001101
101C1100C01P000C0101
11000001000000001C01
11111111111111111111