11111111111111111111
11C10100100100000011
101000010CCC10C00001
110C01C1100000CC0011
1C100C11001010001001
1000011E101001010001
10000000001011001101
101C1100C01P100C0101
11000001000100001C01
11111111111111111111