11111111111111111111
1000010C0000000100C1
10100000010C10000011
10C0CC0010000010CC01
1CC10000000000001001
1000000C000110000011
10E010C00P0010000011
1000001000010C001001
1100C1C0010100000001
11111111111111111111