11111111111111111111
1E001111000C010000P1
10C01110011000C11001
1CC00000C11000111001
1CC00000C11000111001
1CC00000C11000111001
10001111000C01000001
10C01110011000C11011
1CC00000C11000111001
1CC00000C11100111001
1CC00000C11100111001
1CC00000C11000111001
1CC00000111000111001
1CC00000111000111001
1011101000001011C001
11111110111000000111
10000C10011111110111
10010000001110C10001
1000000000C00001C001
11111111111111111111