11111111111111111111
10E01111000C0100P001
10C01110011000C11011
1CC00000C11000111001
1011101000001011C001
11111110111000000111
10C00010011111111111
10010000001110000001
1000CCC00000C001C001
11111111111111111111