58885555888888888885
6XEX4559XXXCXFXXPXX4
6XCX789XX03XXXC03XF4
6CCXXXXXC79XXX059XX4
6X023XFXXXXXFX79CXX4
6X789CFXXCXXXXXXX025
6XCXXXFXXF03XXXXX785
6XXFXXXXXX79FXXFXXX4
6XXXCCCXXXXXCXXFCXX4
52222222222222222225