11111111111111111111
1000000110000001CC01
100C0100100000100001
1C000101000C001010C1
10000010101000000101
100C001000000C000101
1C00000000010CC00101
10100001000C0000C001
10P0000C00C00001E001
11111111111111111111