11111111111111111111
10000C00110000100001
1000C1P0C01000001001
1000C010000010000011
10C000110CC000001001
10100000000000000001
1000C010000000011101
10001000100CC00000C1
111000EC100CC0110C01
11111111111111111111