11111111111111111111111111111111111111111111111111
1000000000000000110000100C100010000010001110000011
10010101000000000000000010001000100000000101000001
10100000101000001000001010000000000111100010001011
10100100000010010000101000000000110000000000100011
10000C1001010001100P000010000C00010011010100100001
1010000000000000000001001001100100010011001CC00001
10001100100000000000000000100001000000000000000001
1011000C00001C000010100010100000100101000000011111
100000000C01001C000000C001100C000000010C0111111011
11000000000000010000000000000010100001011110000001
10100011100010100000100000110000C00000001000000101
100000001000100000101000010011001000000010C00C1001
1C0011010001000011010000010100000100000010000C0011
100001100000000000000101101000000011000010C00000C1
100000000000100C1000001001000000000000101101010001
11CCC0100100C00000100000C0100001000010000100000001
11111111111110111111111111111111111111111100000001
11110011111110111111000100100000000001011100000101
10011110000000000001111100111000011111110001000111
10000001100001010100000000101111010100000000000001
11110001000000000101100000C0100100000000CCC0C10101
10100000000000010000001101000100000000000000100011
11000100010000100010000100010100000000011100000111
100010000100000000000000100000000000001000C0000001
10001010010010000010011011010011C00000000000001001
1000000000000010000101000100000100000010010000E011
11111111111111111111111111111111111111111111111111