111111111111111111111111111111111111111111111111111
100000001100100000000000000000000001010101010111111
1100000000011000000000000000000000000000000E0011111
11000000000000000000000000000000C000000000000011111
100001000000000001000000000000000000000000000011111
100001000100000100100000000000000000000000000011111
11100000000001P000000000000000000000000000000011111
110100011011001010000000000000000000000000000011111
110000100000001000100000000000000000000000000011111
111111111111111111111111111111111111111111111111111