111111111111111111111111111111111111111111111111111
100000001100100000000000000000000001010101010111111
11000X0000011000000000000000000000000000000E0011111
110000000000000000000XX0000000000000000000000011111
10000100000000000100XXXX000000000000000000000011111
1000010001000001001000X0000000000000000000000011111
11100000000001P000000000000000000000000000000011111
110100011011001010000000000000000000000000000011111
110000100000001000100000000000000000000000000011111
111111111111111111111111111111111111111111111111111