11111111111111111111
1000C0001100100C0111
11E0C0C0000110C00001
110000000000000000C1
100C0100000000000101
10C0010001C000010011
11100000000C01P000C1
110100C11011001C1001
1100001000C00C100011
11111111111111111111